------------------------
----OOOOOOOOOOOOOOOO----
----OOOOOOOOOOOOOOOO----
----OOOOOOOOOOOOOOOO----
----OOOOOOOOOOOOOOOO----
----OOOOOOOOOOOOOOOO----
----OOOOOOOOOOOOOOOO----
----OOOOOOOOOOOOOOOO----
----OOOOOOOOOOOOOOOO----
----OOOOOOOOOOOOOOOO----
----OOOOOOOOOOOOOOOO----
----OOOOOOOOOOOOOOOO----
----OOOOOOOOOOOOOOOO----
----OOOOOOOOOOOOOOOO----
XXXXXXXXXXXXXXXXXXXXXXXX
------------------------