------------------------
------------------------
------------------------
----XXXXO----OXXXX------
----XOOXO----OXOOX------
----XOOXO----OXOOX------
----XOOXO----OXOOX------
----XOOXO----OXOOX------
----XOOXO----OXOOX------
----XOOXO----OXOOX------
----XOOXO----OXOOX------
----XOOXOOOOOOXOOX------
----XOOXXXXXXXXOOXB-----
----X-------------------
----X-------------------
----X-------------------