------------------------
------------------------
------------------------
----XXXX------XXXX------
----XOOXO----OXOOX------
----XOOXO----OXOOX------
----XOOXO----OXOOX------
----XOOXO----OXOOX------
----XOOXO----OXOOX------
----XOOXO----OXOOX------
----XOOXO----OXOOX------
----XOOXOOOOOOXOOX------
----XOOXXXXXXXXOOXB-----
----X-------------------
----X-------------------
----X-------------------