Budget [1]
100

Towers [3]
0, 1, 2, 3, 4

Upgrades [7]
1

Waves [10]
5 1

Map [13-28]
------------------------
XXO---------XXXXXXXX----
OXXO-O------XOOOOOOX----
-OXXO--O----XOOOOOOX----
--OXXO---O-OXOOOOOOX----
---OXXOO---OXOOOOOOX----
----OXXOOOOOXOOOOOOX----
-----OXXXXXXX------X----
-------------------X----
-------------------X----
-------------------X----
--OOOOOOOOOOO----OOX----
--BXXXXXXXXXXOOOXXXX----
-----------OX-O-XO------
------------XXXXX-------
------------------------

NextLevel[31]
End

Messages [34+]
0:Test
1:Attention
2:Wop
3:GG