------------------------
------------------------
------------------------
-----------O------------
------------------------
------------------------
------------------------
------------------------
------------------------
------------------------
------------------------
------------------------
------------------------
-----------O------------
XXXXXXXXXXXXXXXXXXXXXXXX
------------------------