--X---------------------
-XX---------------------
-X---XXXXXXXXXX---------
-X---X--------X---------
-X---X-O----O-X---------
-X---X--------X---------
-X---X--------X---------
-X---X-O----O-X---------
-X---X--------X---------
-X---XXXXB----X---------
-X------------X---------
-X-O---O----O-X---------
-X------------X---------
-XXXXXXXXXXXXXX---------
------------------------
------------------------